S..#..........
.#.#.#####..#.
.#.#.....#..#.
.#.#####.#..#.
.#.....#.#..#.
.#####.#.#..#.
.....#.#.#....
###.#.#.#####.
...#.#.....#..
.#.#.#####.#..
.#.#.....#.#..
.#.#####.#.#..
.#.......#...G
..............
